####H####
####-####
####-####
####-####
####-####
####-####
###---###
###-B-###
####O####
