#########
H-----###
###---###
####-####
####-####
#----####
#--##-###
#B--#####
#O#######
