#########
OB----###
###-#-###
###-#-###
##--#--##
###-#-###
###---###
####----H
#########
